####### 
S     # 
##### # 
#  F# # 
# ### # 
#     # 
####### 
