##S##########  
#     #     #  
##### # #####  
#   # # #   #  
# #       ###  
#### #### # F  
#      #    #  
#############  
