#########S### 
#   #       # 
### # ##### # 
#       # # # 
### ### # # # 
#   # # # # # 
# ### # # ### 
# #   #     # 
# ### ### ### 
#       # # # 
### # # # # # 
#   # #     # 
###F######### 

